###############################
S               #         # # #
# # ### ####### ### ####### # #
# #   #       #   #       # # #
# ### # ### # # # # ##### # # #
#   # #   # # # # # #   # # # #
### # ##### # # # # ### # # # #
#   #       # #   #     # #   #
# ### ####### # ### ###########
#   #         #   #     #     #
### # ########### # ### # ### #
# #   #   # #   # # #   # #   #
# # ### # # ### # # # ### # # #
# #   # # #   # # # #     # # #
# ### # # ### # # # ####### # #
#     # #     #   # #       # #
# ##### # ######### # ####### #
#     # # #         # #       #
##### # # # ####### # # #######
#   #   # #       # # #   #   #
# # ##### ######### # ####### #
# #                 #         #
# ########################### #
#                             #
#############################F#